15 5 5 2
###############
#       ##    #
#    #     #  #
B        # #  S
#######S#######
