30 10 10 3
##############################
B    #    ###  ##    #       #
#    #    ##   ##    #       #
###      ##    ##    #       #
#         ##   #        ##   S
#      #  #####    #    ##   #
#         #  S   #   #   #####
#         #####  #   #########
#                            #
##############################
